%%%%%%%%%%%%%%%%%%%%%%%%%%%%%%%
%............%%%%%............%
%%%.%...%%%.........%.%...%.%%%
%...%%%.%.%%%%.%.%%%%%%.%%%...%
%.%.....%......%......%.....%.%
%.%%%.%%%%%.%%%%%%%.%%%.%.%%%%%
%.....%.......P ....%...%.....%
%%%%%%%%%%%%%%%%%%%%%%%%%%%%%%%
